506020903
008000500
000000000
600285009
000903000
800761004
000000000
004000300
201050607
